00000000000000000000000000000000000000000000000000
00000000000004444444440000000000000000000000000000
00000000000004444444440000000000002222220000000000
00000000000004444444440000000000002222220000000000
00000000000000000000000000000000002222220000000000
00000000000000000000000000000000002222220000000000
00000000000000000000000000000000003333330000000000
00000000000000000000000000000000003333330000000000
00000000000000000000000000000000003333330000000000
00000000000000000000000000000000003333330000000000
00000000000000000000000000000000003333330000000000
00000000000033333333333333000000000000000000000000
00000000000033333333333333000000000000000000000000
00000000000033333333333333000000000000000000000000
00000000000000000000000000000000000000000000000000
00000000000000000000000000001111000000000000000000
00000000000000000000000000001111000000000000000000
00000000000000000000000000001111000000000000000000
00000000000000000000000000001111000000000000000000
00000000000000000000000000001111000000000000000000
00000000000055555555555555000000000000000000000000
00000000000055555555555555000000000000000000000000
00000000000055555555555555000000000000000000000000
00000000000055555555555555000000000000000000000000
00000000000055555555555555000000000000000000000000
00000000000000000000000000000000000000000000000000
00000000000000000000000000000000000000000000000000
00000000000000000000000000000000000000000000000000
00000000000000000000000000000000000000000000000000
00000000000000000000000000000000000000000000000000
00000000000000000000000000000000000000000000000000
00000000000000000000000000000000000000000000000000
00000000000000000000000000000000000000000000000000
00000000000000000000000000000000000000000000000000
00000000000000000000000000000000000000000000000000
00000000000000000000000000000000000000000000000000
00000000000000000000000000000000000000000000000000
00000000000000000000000000000000000000000000000000
00000000000000000000000000000000000000000000000000
00000000000000000000000000000000000000000000000000
00000000000000000000000000000000000000000000000000
00000000000000000000000000000000000000000000000000
00000000000000000000000000000000000000000000000000
00000000000000000000000000000000000000000000000000
00000000000000000000000000000000000000000000000000
00000000000000000000000000000000000000000000000000
00000000000000000000000000000000000000000000000000
00000000000000000000000000000000000000000000000000
00000000000000000000000000000000000000000000000000